/.......D......D......D.......
..#A.....................DD###
..............................
..............................
..H.....D......D......D....../
B.#A.......................#..
/.............................
..............................
.................D............
....../A...................#.B
............................./
......##.....................G
!....#......C......E....F....#
##############################