000000000000000000000000000000
001100100100100100100100100111
000000000000000000000000000000
010000000000000000000000000000
000000000000000000000000000000
001100100100100100100100110000
000000000000000000000000000000
000000000000000000000000001000
000000000000000000000000000000
900000001100100100100100110000
000000000000000000000000000000
000000110000000000000000000000
000001000000000000000000000000
111111111111111111111111111111