000000000000000000000000000000
112200000000000000000000000111
000000000000000000000000000000
000000000000000000000000000000
030000000000000000000000000000
100000000000000000000000440011
000000000000000000000000000000
000000000000000000000000000000
000000000000000000000000003000
000000002200000000000000000011
000000000000000000000000000000
000000110000000000000000000000
900001000000000000000000000000
111111111111111111111111111111